10000000000000010100000000000000
10000000000000100010000000000001
10000000000001000001000000000010
10000000000010000000100000000100
10000000000100000000010000001000
10000000001000000000001000010000
10000000010000000000000100100000
10000000100000000000000011000000
10000001000000000000000011000000
10000010000000000000000100100000
10000100000000000000001000010000
10001000000000000000010000001000
10010000000000000000100000000100
10100000000000000001000000000010
10000000000000000010000000000001
10000000000000000100000000000000
AAAAAAAAAAAAAAAAAAAAAAAAAAAAAAAA
. .            . .   .       . .
